12
1,5,6,2,2,3,6,3,6,2,2,2
3,5,14,11,14,10,10,10,9,14,11,14
11,5,14,10,8,10,11,14,2,10,10,10
10,1,14,10,3,14,10,11,14,11,14,10
9,5,15,12,10,8,8,8,8,8,8,10
1,5,13,5,12,3,6,1,5,5,5,14
1,5,7,5,6,9,14,3,4,3,5,12
3,5,15,4,9,5,12,11,4,11,5,6
9,5,15,5,7,5,4,9,5,14,1,12
3,5,15,4,9,5,5,6,1,15,5,6
9,5,15,5,4,3,4,11,5,15,5,12
1,5,13,5,5,12,1,12,1,13,5,4